Boston College: Thomas Castellanos

California: Fernando Mendoza

Clemson: Cade Klubnik

Duke: Maalik Murphy

Florida State: DJ Uiagalelei

Georgia Tech: Haynes King

Louisville: Tyler Shough

Miami: Cam Ward

North Carolina: Max Johnson

NC State: Grayson McCall

Pittsburgh: Nate Yarnell

Stanford: Ashton Daniels

SMU: Preston Stone

Syracuse: Kyle McCord

Virginia: Anthony Colandrea

Virginia Tech: Kyron Drones

Wake Forest: Hank Bachmeier

Illinois: Luke Altmyer

Indiana: Kurtis Rourke

Iowa: Cade McNamara

Maryland: MJ Morris

Michigan: Alex Orji

Michigan State: Aidan Chiles

Minnesota: Max Brosmer

Nebraska: Dylan Raiola

Northwestern: Jack Lausch

Ohio State: Will Howard

Oregon: Dillon Gabriel

Penn State: Drew Allar

Purdue: Hudson Card

Rutgers: Athan Kaliakmanis

UCLA: Ethan Garbers

USC: Miller Moss

Washington: Will Rogers

Wisconsin: Tyler Van Dyke

Alabama: Jalen Milroe

Arkansas: Taylen Green

Auburn: Payton Thorne

Florida: Graham Mertz

Georgia: Carson Beck

Kentucky: Brock Vandagriff

LSU: Garrett Nussmeier

Mississippi State: Blake Shapen

Missouri: Brady Cook

Oklahoma: Jackson Arnold

Ole Miss: Jaxson Dart

South Carolina: LaNorris Sellers

Tennessee: Nico Iamaleava

Texas: Quinn Ewers

Texas A&M: Conner Weigman

Vanderbilt: Diego Pavia

Arizona: Noah Fifita

Arizona State: Sam Leavitt

Baylor: Dequan Finn

BYU: Gerry Bohanon

Cincinnati: Brendan Sorsby

Colorado: Shedeur Sanders

Houston: Donovan Smith

Iowa State: Rocco Becht

Kansas: Jalon Daniels

Kansas State: Avery Johnson

Oklahoma State: Alan Bowman

TCU: Josh Hoover

Texas Tech: Behren Morton

UCF: KJ Jefferson

Utah: Cameron Rising

West Virginia: Garrett Greene